{
    "track": [
        [7, 1, 5, false, false, 1],
        [6, 1, 5],
        [5, 1, 5],
        [4, 1, 5],
        [3, 1, 5],
        [2, 1, 5],
        [1, 1, 1],
        [1, 2, 4],
        [1, 3, 4],
        [1, 4, 4],
        [1, 5, 0],
        [2, 5, 5],
        [3, 5, 6, 3, 2],
        [2, 3, 5],
        [3, 3, 5],
        [4, 3, 5],
        [5, 3, 2],
        [5, 4, 4],
        [5, 5, 0],
        [6, 5, 5],
        [6, 4, 4],
        [8, 4, 4],
        [7, 5, 5],
        [8, 5, 3],
        [6, 3, 6, 0, 1],
        [8, 3, 6, 0, 0]
    ],
    "timetable": {
        "0": null,
        "5": null,
        "10": null,
        "15": null,
        "20": null,
        "25": null
    }
}