{
    "track": [
        [0, 0, 4, false, false, 0],
        [0, 1, 4],
        [5, 1, 6, 3, 1],
        [2, 2, 6, 2, 2],
        [5, 4, 6, 3, 3],
        [0, 6, 6, 1, 4],
        [4, 7, 6, 2, 5],
        [6, 9, 6, 0, 6],
        [0, 2, 0],
        [1, 2, 3],
        [1, 1, 4],
        [1, 0, 1],
        [2, 0, 5],
        [3, 0, 5],
        [4, 0, 2],
        [4, 1, 4],
        [4, 2, 4],
        [4, 3, 3],
        [3, 3, 5],
        [2, 3, 5],
        [1, 3, 1],
        [1, 4, 0],
        [2, 4, 5],
        [3, 4, 5],
        [4, 4, 2],
        [4, 5, 3],
        [3, 5, 5],
        [2, 5, 5],
        [1, 5, 1],
        [1, 6, 4],
        [1, 7, 4],
        [1, 8, 0],
        [2, 8, 3],
        [2, 7, 4],
        [2, 6, 1],
        [3, 6, 2],
        [3, 7, 4],
        [3, 8, 0],
        [4, 8, 5],
        [5, 8, 5],
        [6, 8, 5],
        [7, 8, 3],
        [7, 7, 4],
        [7, 6, 2],
        [6, 6, 0],
        [6, 5, 4],
        [6, 4, 1],
        [7, 4, 2],
        [7, 5, 0],
        [8, 5, 3],
        [8, 4, 4],
        [8, 3, 2],
        [7, 3, 0],
        [7, 2, 6, 2, 0]
    ],
    "timetable": {
        "0": null,
        "5": null,
        "10": null,
        "15": null,
        "20": null,
        "25": null,
        "30": null,
        "35": null,
        "40": null,
        "45": null,
        "50": null
    }
}